###########
#1        #
# #+# # # #
# + +     #
# #+# # # #
#         #
# # # # # #
#         #
###########
