###########
#1        #
#         #
#         #
#         #
#         #
#         #
#         #
###########