###########
#1        #
# #+# # # #
# ++             #
# #+# # # #
#         #
# # # # # #
#         #
###########