      
      
##### #####
#1        #
# #+# # # #
# ++      #
# #+# # # #
#         #
# # # # # #
#         #
###########