###########
#1     ++ #
# #+# # # #
# + +   ++#
#+#+# # #+#
#+       +#
# #+# #+# #
#   ++++  #
###########
