##################  ##################  ##################
#               1#  +                #  +                #
#   ##############  #  ###############  ###############  #
#   #               #  #                              #  #
#   #               #  #   ###########                #  #
#   #               #  #   +         #  ####          #  #
#   #               #  #   #######   #  #++#          #  #
#   ##############  #   ##########   #  #  ############  #
#                +  #                #  #                #
##################  ##################  ##################